
111111111111111111111111111
1E000000000000C00000C000001
101010100100000101001010101
101010010101010001001010101
1P000000C00C0000000000000C1
111111111111111111111111111