1111111
1ECCC01
101C1P1
1111111