111111
10CC01
100001
10ECP1
10C001
111111