11111111
10CC0CC1
10011011
10ECP001
10C00101
11111111