111111
1ECC01
1011P1
100C01
10C001
111111
