111111
10CC01
1011P1
1E0C01
10C001
111111