1111111
1ECCC01
10101P1
1111111